1111111111111111111111111111
1PCCCCCCCCCCC11CCCCCCCCCCCC1
1C1111C11111C11C11111C1111C1
1C1001C10001C11C10001C1001C1
1C1111C11111C11C11111C1111C1
1CCCCCCCCCCCCCCCCCCCCCCCCCC1
1C1111C11C11111111C11C1111C1
1C1111C11C11111111C11C1111C1
1CCCCCC11CCCC11CCCC11CCCCCC1
111111C11111C11C11111C111111
100001C11111C11C11111C100001
100001C11CCCCCCCCCC11C100001
100001C11C11111111C11C100001
100001C11C10000001C11C100001
100001CCCC10325401CCCC100001
100001C11C10000001C11C100001
100001C11C11111111C11C100001
100001C11CCCCCCCCCC11C100001
100001C11C11111111C11C100001
111111C11C11111111C11C111111
1CCCCCCCCCCCC11CCCCCCCCCCCC1
1C1111C11111C11C11111C1111C1
1C1111C11111C11C11111C1111C1
1CCC11CCCCCCCCCCCCCCCC11CCC1
111C11C11C11111111C11C11C111
111C11C11C11111111C11C11C111
1CCCCCC11CCCC11CCCC11CCCCCC1
1C1111111111C11C1111111111C1
1C1111111111C11C1111111111C1
1CCCCCCCCCCCCCCCCCCCCCCCCCC1
1111111111111111111111111111
